sbm_id,para_nr,word_nr,word,duration,start_t,end_t,x_mean,y_mean,response
8,1,48, had. ,100,2123,2223,488,204,advantages
8,1,24, you ,101,2223,2324,476,138,advantages
8,1,0, In ,1899,2324,4223,472.68,93.16,advantages
8,1,1, my ,101,4223,4324,496,97,advantages
8,1,2, younger ,400,4324,4724,540.5,97.75,advantages
8,1,3, and ,399,4724,5123,587.75,93,advantages
8,1,4, more ,200,5123,5323,634.5,94,advantages
8,1,5, vulnerable ,503,5323,5826,689.4,96.6,advantages
8,1,6, years ,101,5826,5927,754,99,advantages
8,1,7, my ,100,5927,6027,784,100,advantages
8,1,8, father ,202,6027,6229,821.5,101,advantages
8,1,9, gave ,195,6229,6424,867,97,advantages
8,1,10, me ,305,6424,6729,904.67,97,advantages
8,1,7, my ,198,6729,6927,785.5,83.5,advantages
8,1,2, younger ,198,6927,7125,524,98,advantages
8,1,12, advice ,503,7125,7628,487,118.8,advantages
8,1,13, that ,103,7628,7731,524,120,advantages
8,1,14, I've ,101,7731,7832,550,120,advantages
8,1,15, been ,192,7832,8024,600.5,124.5,advantages
8,1,16, turning ,504,8024,8528,644.2,127,advantages
8,1,17, over ,102,8528,8630,703,124,advantages
8,1,18, in ,104,8630,8734,726,124,advantages
8,1,19, my ,95,8734,8829,749,124,advantages
8,1,20, mind ,200,8829,9029,789,125.5,advantages
8,1,21, ever ,194,9029,9223,849,131.5,advantages
8,1,22, since. ,107,9223,9330,886,129,advantages
8,1,23, Whenever ,393,9330,9723,933.75,120.25,advantages
8,1,21, ever ,106,9723,9829,775,106,advantages
8,1,4, more ,101,9829,9930,556,108,advantages
8,1,12, advice ,199,9930,10129,493.5,126,advantages
8,1,24, you ,695,10129,10824,479.57,151.57,advantages
8,1,25, feel ,301,10824,11125,511.33,146.33,advantages
8,1,26, like ,303,11125,11428,541.67,150,advantages
8,1,27, criticizing ,500,11428,11928,594.2,155.6,advantages
8,1,28," anyone, ",197,11928,12125,666,153,advantages
8,1,29, he ,199,12125,12324,707,150.5,advantages
8,1,30, told ,100,12324,12424,736,150,advantages
8,1,31, me ,1000,12424,13424,771.2,151.1,advantages
8,1,30, told ,501,13424,13925,736,152,advantages
8,1,29, he ,600,13925,14525,707.83,152,advantages
8,1,30, told ,200,14525,14725,731,149.5,advantages
8,1,31, me ,400,14725,15125,761.5,149,advantages
8,1,29, he ,100,15125,15225,707,149,advantages
8,1,28," anyone, ",401,15225,15626,668,150.25,advantages
8,1,27, criticizing ,98,15626,15724,595,154,advantages
8,1,26, like ,100,15724,15824,555,155,advantages
8,1,25, feel ,601,15824,16425,511.17,145.17,advantages
8,1,26, like ,101,16425,16526,549,148,advantages
8,1,27, criticizing ,99,16526,16625,592,150,advantages
8,1,28," anyone, ",199,16625,16824,669.5,150,advantages
8,1,29, he ,501,16824,17325,701.4,150,advantages
8,1,30, told ,199,17325,17524,730.5,152,advantages
8,1,31, me ,101,17524,17625,774,156,advantages
8,1,32," had, ",499,17625,18124,792.2,156,advantages
8,1,31, me ,100,18124,18224,755,151,advantages
8,1,29, he ,700,18224,18924,704.71,147.14,advantages
8,1,30, told ,200,18924,19124,731,147,advantages
8,1,31, me ,100,19124,19224,767,147,advantages
8,1,32," had, ",400,19224,19624,796,150,advantages
8,1,31, me ,500,19624,20124,734.2,161.2,advantages
8,1,30, told ,501,20124,20625,725.4,147.6,advantages
8,1,31, me ,98,20625,20723,768,146,advantages
8,1,32," had, ",101,20723,20824,801,147,advantages
8,1,33, 'just ,500,20824,21324,840.2,150.8,advantages
8,1,34, remember ,500,21324,21824,928.4,161.4,advantages
8,1,35, that ,1100,21824,22924,942.73,146.27,advantages
8,1,34, remember ,401,22924,23325,906.25,157.75,advantages
8,1,32," had, ",99,23325,23424,808,141,advantages
8,1,30, told ,300,23424,23724,735.33,142.33,advantages
8,1,29, he ,100,23724,23824,718,146,advantages
8,1,30, told ,101,23824,23925,740,144,advantages
8,1,32," had, ",99,23925,24024,793,141,advantages
8,1,33, 'just ,100,24024,24124,822,141,advantages
8,1,34, remember ,700,24124,24824,899.43,145.57,advantages
8,1,29, he ,101,24824,24925,699,139,advantages
8,1,27, criticizing ,99,24925,25024,564,154,advantages
8,1,25, feel ,300,25024,25324,466.67,160,advantages
8,1,36, all ,400,25324,25724,471.25,180.25,advantages
8,1,37, the ,100,25724,25824,493,181,advantages
8,1,38, people ,300,25824,26124,534.33,177.33,advantages
8,1,39, in ,101,26124,26225,580,170,advantages
8,1,40, this ,99,26225,26324,600,170,advantages
8,1,41, world ,500,26324,26824,633,172.8,advantages
8,1,42, haven't ,301,26824,27125,691.33,175.67,advantages
8,1,43, had ,199,27125,27324,733.5,173,advantages
8,1,44, the ,101,27324,27425,768,173,advantages
8,1,45, advantages ,499,27425,27924,841.2,177.6,advantages
8,1,28," anyone, ",101,27924,28025,678,153,advantages
8,1,25, feel ,99,28025,28124,505,157,advantages
8,1,36, all ,601,28124,28725,468.83,177.33,advantages
8,1,48, had. ,2962,28725,31687,475,202,advantages
8,2,0, Neighbours ,399,538,937,497,93.75,Boo
8,2,11, things ,101,937,1038,490,107,Boo
8,2,0, Neighbours ,1099,1038,2137,510.27,89.82,Boo
8,2,1, bring ,400,2137,2537,574.25,98,Boo
8,2,2, food ,401,2537,2938,610,101.75,Boo
8,2,1, bring ,99,2938,3037,582,102,Boo
8,2,0, Neighbours ,400,3037,3437,526.5,101,Boo
8,2,1, bring ,306,3437,3743,592,105,Boo
8,2,2, food ,200,3743,3943,628,98.5,Boo
8,2,3, with ,398,3943,4341,651,90.25,Boo
8,2,4, death ,496,4341,4837,685.6,93,Boo
8,2,5, and ,102,4837,4939,732,92,Boo
8,2,6, flowers ,101,4939,5040,778,89,Boo
8,2,7, with ,200,5040,5240,818.5,89.5,Boo
8,2,8, sickness ,405,5240,5645,872.75,91,Boo
8,2,9, and ,296,5645,5941,924,92,Boo
8,2,7, with ,101,5941,6042,828,93,Boo
8,2,4, death ,95,6042,6137,700,94,Boo
8,2,2, food ,102,6137,6239,598,103,Boo
8,2,13, between. ,99,6239,6338,551,112,Boo
8,2,12, in ,99,6338,6437,519,117,Boo
8,2,11, things ,304,6437,6741,501,122,Boo
8,2,12, in ,97,6741,6838,512,121,Boo
8,2,13, between. ,403,6838,7241,569.5,119.5,Boo
8,2,14, Boo ,196,7241,7437,622,116,Boo
8,2,15, was ,200,7437,7637,655,117.5,Boo
8,2,16, our ,109,7637,7746,681,122,Boo
8,2,17, neighbour. ,293,7746,8039,730,124,Boo
8,2,18, He ,98,8039,8137,793,121,Boo
8,2,19, gave ,203,8137,8340,829,121,Boo
8,2,20, us ,98,8340,8438,863,121,Boo
8,2,21, two ,104,8438,8542,883,121,Boo
8,2,20, us ,103,8542,8645,877,122,Boo
8,2,17, neighbour. ,96,8645,8741,773,119,Boo
8,2,13, between. ,102,8741,8843,585,119,Boo
8,2,11, things ,201,8843,9044,507,121,Boo
8,2,23," dolls, ",95,9044,9139,501,164,Boo
8,2,37, lives. ,199,9139,9338,501,165.5,Boo
8,2,24, a ,99,9338,9437,516,144,Boo
8,2,25, broken ,301,9437,9738,543.33,144,Boo
8,2,26, watch ,405,9738,10143,609.25,153.5,Boo
8,2,27, and ,96,10143,10239,626,153,Boo
8,2,28," chain, ",105,10239,10344,676,152,Boo
8,2,29, a ,94,10344,10438,711,152,Boo
8,2,30, pair ,99,10438,10537,749,156,Boo
8,2,31, of ,405,10537,10942,840,158,Boo
8,2,34," pennies, ",703,10942,11645,893.29,146,Boo
8,2,33, luck ,94,11645,11739,838,151,Boo
8,2,27, and ,106,11739,11845,564,162,Boo
8,2,37, lives. ,4152,11845,15997,529.98,181.6,Boo
8,3,0, I ,100,1607,1707,467,84,story
8,3,1, wanted ,900,1707,2607,497.67,97.33,story
8,3,3, live ,403,2607,3010,576,103,story
8,3,4, deep ,298,3010,3308,600,95,story
8,3,5, and ,200,3308,3508,644.5,92,story
8,3,6, suck ,299,3508,3807,677.67,89,story
8,3,7, out ,402,3807,4209,696.25,89,story
8,3,8, all ,99,4209,4308,735,94,story
8,3,9, the ,100,4308,4408,764,95,story
8,3,10, marrow ,399,4408,4807,798.5,92.25,story
8,3,11, of ,100,4807,4907,840,93,story
8,3,12," life, ",100,4907,5007,867,93,story
8,3,13, to ,101,5007,5108,892,93,story
8,3,14, live ,199,5108,5307,915,89.5,story
8,3,12," life, ",400,5307,5707,860,83,story
8,3,1, wanted ,102,5707,5809,520,99,story
8,3,16, sturdily ,899,5809,6708,491.44,120.56,story
8,3,17, and ,600,6708,7308,535.33,119.67,story
8,3,1, wanted ,1806,7308,9114,566.78,86.94,story
8,3,2, to ,93,9114,9207,531,89,story
8,3,3, live ,101,9207,9308,558,91,story
8,3,4, deep ,100,9308,9408,599,92,story
8,3,5, and ,399,9408,9807,650.75,89,story
8,3,6, suck ,101,9807,9908,694,100,story
8,3,7, out ,202,9908,10110,714,104,story
8,3,8, all ,200,10110,10310,731,95.5,story
8,3,9, the ,299,10310,10609,752.67,90.67,story
8,3,10, marrow ,403,10609,11012,796.25,91.25,story
8,3,11, of ,110,11012,11122,837,90,story
8,3,12," life, ",189,11122,11311,863,89,story
8,3,13, to ,99,11311,11410,887,89,story
8,3,14, live ,1598,11410,13008,924,89.12,story
8,3,13, to ,400,13008,13408,883,82,story
8,3,1, wanted ,200,13408,13608,479.5,100.5,story
8,3,16, sturdily ,1000,13608,14608,483.2,123,story
8,3,17, and ,204,14608,14812,530,124,story
8,3,18, Spartan-like ,796,14812,15608,591.75,121.12,story
8,3,19, as ,209,15608,15817,658,123.5,story
8,3,20, to ,192,15817,16009,677,118,story
8,3,21, put ,204,16009,16213,700.5,121.5,story
8,3,22, to ,195,16213,16408,727,125,story
8,3,23, rout ,1200,16408,17608,759.58,122.17,story
8,3,24, all ,200,17608,17808,784,125,story
8,3,25, that ,201,17808,18009,815,126,story
8,3,26, was ,199,18009,18208,846,124.5,story
8,3,27, not ,300,18208,18508,878.67,117,story
8,3,28," life, ",103,18508,18611,903,115,story
8,3,29, to ,98,18611,18709,925,115,story
8,3,30, cut ,300,18709,19009,946.67,115.33,story
8,3,28," life, ",99,19009,19108,903,127,story
8,3,27, not ,103,19108,19211,791,133,story
8,3,35, shave ,100,19211,19311,655,143,story
8,3,33, swath ,198,19311,19509,553.5,142,story
8,3,32, broad ,899,19509,20408,499.56,146.56,story
8,3,33, swath ,300,20408,20708,553,147,story
8,3,34, and ,202,20708,20910,594,147.5,story
8,3,35, shave ,499,20910,21409,638.6,150,story
8,3,36," close, ",1199,21409,22608,675.5,152.5,story
8,3,37, to ,100,22608,22708,715,152,story
8,3,38, drive ,201,22708,22909,748,152,story
8,3,39, life ,299,22909,23208,784.67,152,story
8,3,40, into ,300,23208,23508,808,151.67,story
8,3,41, a ,203,23508,23711,832.5,147.5,story
8,3,42," corner, ",398,23711,24109,866,145,story
8,3,43, and ,101,24109,24210,900,144,story
8,3,42," corner, ",98,24210,24308,884,151,story
8,3,50," and, ",103,24308,24411,683,169,story
8,3,32, broad ,98,24411,24509,486,147,story
8,3,31, a ,302,24509,24811,464,147,story
8,3,44, reduce ,697,24811,25508,485.71,174.71,story
8,3,45, it ,102,25508,25610,527,175,story
8,3,46, to ,99,25610,25709,543,175,story
8,3,47, its ,600,25709,26309,566.5,175,story
8,3,48, lowest ,303,26309,26612,609.33,181,story
8,3,49," terms, ",199,26612,26811,656.5,183,story
8,3,50," and, ",301,26811,27112,694,185,story
8,3,51, if ,197,27112,27309,723.5,178.5,story
8,3,52, it ,304,27309,27613,735.67,177,story
8,3,53, proved ,595,27613,28208,755,178,story
8,3,54, to ,200,28208,28408,809.5,183.5,story
8,3,55, be ,201,28408,28609,828.5,181,story
8,3,56," mean, ",502,28609,29111,866.2,179.6,story
8,3,57, why ,300,29111,29411,913.67,178.67,story
8,3,56," mean, ",403,29411,29814,654.5,188.5,story
8,3,60, get ,102,29814,29916,503,192,story
8,3,59, to ,695,29916,30611,469,201.29,story
8,3,60, get ,203,30611,30814,495.5,202.5,story
8,3,61, the ,119,30814,30933,526,204,story
8,3,62, whole ,298,30933,31231,553.67,208,story
8,3,63, and ,282,31231,31513,605.33,209,story
8,3,64, genuine ,1096,31513,32609,663.73,205.27,story
8,3,65, meanness ,504,32609,33113,716.2,203,story
8,3,66, of ,100,33113,33213,772,203,story
8,3,67," it, ",96,33213,33309,794,203,story
8,3,68, and ,205,33309,33514,823,204,story
8,3,69, publish ,295,33514,33809,853.33,204.67,story
8,3,68, and ,100,33809,33909,812,210,story
8,3,64, genuine ,99,33909,34008,657,194,story
8,3,62, whole ,114,34008,34122,576,198,story
8,3,60, get ,287,34122,34409,490.33,211.67,story
8,3,71, meanness ,900,34409,35309,488.56,228.56,story
8,3,72, to ,200,35309,35509,554,228,story
8,3,73, the ,207,35509,35716,579.5,228,story
8,3,74, world; ,494,35716,36210,621.2,231.6,story
8,3,75, or ,299,36210,36509,653,233,story
8,3,76, if ,401,36509,36910,666.25,233,story
8,3,77, it ,200,36910,37110,681,230.5,story
8,3,78, were ,503,37110,37613,710.4,226.6,story
8,3,79," sublime, ",597,37613,38210,779.67,222.67,story
8,3,81, know ,99,38210,38309,832,234,story
8,3,82, it ,102,38309,38411,863,236,story
8,3,83, by ,98,38411,38509,878,234,story
8,3,81, know ,100,38509,38609,847,236,story
8,3,87, be ,104,38609,38713,617,258,story
8,3,84," experience, ",596,38713,39309,511.33,256.17,story
8,3,85, and ,500,39309,39809,621.6,265.2,story
8,3,90, give ,200,39809,40009,707.5,260,story
8,3,91, a ,300,40009,40309,728,253,story
8,3,92, true ,201,40309,40510,751.5,256,story
8,3,93, account ,399,40510,40909,806,257,story
8,3,96, in ,101,40909,41010,867,249,story
8,3,97, my ,199,41010,41209,906,245,story
8,3,96, in ,101,41209,41310,868,255,story
8,3,90, give ,100,41310,41410,595,240,story
8,3,71, meanness ,99,41410,41509,471,237,story
8,3,84," experience, ",102,41509,41611,468,249,story
8,3,99, excursion. ,7000,41611,48611,492.01,283.83,story
8,3,21, put ,300,48611,48911,704.67,117.33,story
8,3,36," close, ",118,48911,49029,688,139,story
8,3,50," and, ",83,49029,49112,689,168,story
8,3,65, meanness ,197,49112,49309,693.5,201.5,story
8,3,77, it ,200,49309,49509,683,231,story
8,3,76, if ,103,49509,49612,667,241,story
8,3,74, world; ,104,49612,49716,642,227,story
8,3,48, lowest ,108,49716,49824,608,181,story
8,3,34, and ,185,49824,50009,581,144,story
8,3,18, Spartan-like ,105,50009,50114,556,118,story
8,3,2, to ,298,50114,50412,536.33,95.33,story
8,3,88, able ,2074,50412,52486,654.81,289.43,story
8,4,37, am ,600,42,642,532,183,armpits
8,4,41, scent ,200,642,842,540.5,169,armpits
8,4,40, The ,99,842,941,538,164,armpits
8,4,27, and ,100,941,1041,523,134,armpits
8,4,1, believe ,301,1041,1342,511.33,97.33,armpits
8,4,12," miracles, ",99,1342,1441,521,137,armpits
8,4,27, and ,203,1441,1644,529,163.5,armpits
8,4,40, The ,102,1644,1746,532,180,armpits
8,4,51, more ,396,1746,2142,538.5,200.75,armpits
8,4,40, The ,99,2142,2241,525,179,armpits
8,4,27, and ,101,2241,2342,515,153,armpits
8,4,12," miracles, ",98,2342,2440,506,117,armpits
8,4,1, believe ,102,2440,2542,502,93,armpits
8,4,13, and ,100,2542,2642,550,124,armpits
8,4,43, these ,301,2642,2943,611.33,177.67,armpits
8,4,16, and ,99,2943,3042,650,110,armpits
8,4,7, appetites; ,101,3042,3143,720,101,armpits
8,4,8," Seeing, ",198,3143,3341,769,92.5,armpits
8,4,17, tag ,101,3341,3442,690,126,armpits
8,4,43, these ,101,3442,3543,607,173,armpits
8,4,42, of ,499,3543,4042,593.4,188,armpits
8,4,44," arm-pits, ",499,4042,4541,663,173.4,armpits
8,4,43, these ,100,4541,4641,646,172,armpits
8,4,53," churches, ",600,4641,5241,599.33,199.33,armpits
8,4,44," arm-pits, ",100,5241,5341,650,183,armpits
8,4,54," bibles, ",400,5341,5741,672.25,208.5,armpits
8,4,53," churches, ",100,5741,5841,620,197,armpits
8,4,43, these ,2501,5841,8342,620.08,180.84,armpits
8,4,31, make ,401,8342,8743,620.5,155,armpits
8,4,43, these ,1498,8743,10241,621.4,175.87,armpits
8,4,31, make ,1202,10241,11443,621.58,152.17,armpits
8,4,43, these ,698,11443,12141,622.71,177.14,armpits
8,4,53," churches, ",1900,12141,14041,626.84,200.95,armpits
8,4,43, these ,2000,14041,16041,626.75,182.95,armpits
8,4,53," churches, ",1400,16041,17441,627,189.86,armpits
8,4,43, these ,1201,17441,18642,628,180.83,armpits
8,4,53," churches, ",700,18642,19342,631.57,193.71,armpits
8,4,43, these ,1906,19342,21248,632,176.16,armpits
8,4,31, make ,3194,21248,24442,632,157.12,armpits
8,4,43, these ,999,24442,25441,632.3,177.8,armpits
8,4,53," churches, ",1302,25441,26743,634.92,199.31,armpits
8,4,43, these ,2799,26743,29542,634,174.57,armpits
8,4,31, make ,802,29542,30344,635.5,147.12,armpits
8,4,15, part ,304,30344,30648,637.67,116.33,armpits
8,4,5, and ,305,30648,30953,639,95.67,armpits
8,4,15, part ,89,30953,31042,642,113,armpits
8,4,31, make ,200,31042,31242,636,148.5,armpits
8,4,43, these ,302,31242,31544,634.67,178.33,armpits
8,4,53," churches, ",1103,31544,32647,633.09,191.91,armpits
8,4,43, these ,899,32647,33546,637.44,177.78,armpits
8,4,53," churches, ",796,33546,34342,616.75,199.88,armpits
8,4,52, than ,410,34342,34752,560.75,190,armpits
8,4,41, scent ,1094,34752,35846,560.91,174.18,armpits
8,4,42, of ,896,35846,36742,591.56,159.33,armpits
8,4,43, these ,1706,36742,38448,616.88,172.41,armpits
8,4,44," arm-pits, ",896,38448,39344,679.44,165.56,armpits
8,4,32, holy ,100,39344,39444,697,156,armpits
8,4,33, whatever ,798,39444,40242,704.5,147.12,armpits
8,4,18, of ,1200,40242,41442,715.42,121.08,armpits
8,4,7, appetites; ,902,41442,42344,722.44,98.22,armpits
8,4,19, me ,298,42344,42642,744,126.33,armpits
8,4,33, whatever ,102,42642,42744,751,138,armpits
8,4,45, aroma ,198,42744,42942,767.5,179,armpits
8,4,57, the ,302,42942,43244,774.67,200,armpits
8,4,56, all ,98,43244,43342,769,189,armpits
8,4,45, aroma ,101,43342,43443,763,168,armpits
8,4,33, whatever ,99,43443,43542,752,139,armpits
8,4,7, appetites; ,400,43542,43942,733,89.5,armpits
8,4,33, whatever ,101,43942,44043,755,161,armpits
8,4,45, aroma ,99,44043,44142,764,190,armpits
8,4,56, all ,201,44142,44343,770,211,armpits
8,4,55, and ,100,44343,44443,728,193,armpits
8,4,44," arm-pits, ",99,44443,44542,682,162,armpits
8,4,32, holy ,100,44542,44642,672,140,armpits
8,4,7, appetites; ,300,44642,44942,688.67,86.33,armpits
8,4,17, tag ,100,44942,45042,686,116,armpits
8,4,32, holy ,103,45042,45145,683,143,armpits
8,4,44," arm-pits, ",197,45145,45342,683,179.5,armpits
8,4,54," bibles, ",300,45342,45642,680,203,armpits
8,4,44," arm-pits, ",100,45642,45742,674,167,armpits
8,4,32, holy ,2700,45742,48442,671.33,157.07,armpits
8,4,44," arm-pits, ",201,48442,48643,682,178,armpits
8,4,32, holy ,99,48643,48742,682,153,armpits
8,4,16, and ,1301,48742,50043,654.08,122.38,armpits
8,4,15, part ,1499,50043,51542,630.4,124.13,armpits
8,4,29, and ,1000,51542,52542,590.2,149.6,armpits
8,4,28," out, ",102,52542,52644,569,153,armpits
8,4,27, and ,99,52644,52743,519,147,armpits
8,4,26, inside ,200,52743,52943,499.5,138,armpits
8,4,13, and ,99,52943,53042,544,125,armpits
8,4,29, and ,103,53042,53145,598,152,armpits
8,4,43, these ,17705,53145,70850,617.08,177.82,armpits
8,4,31, make ,108,70850,70958,640,157,armpits
8,4,44," arm-pits, ",291,70958,71249,668.67,172,armpits
8,4,32, holy ,193,71249,71442,686,150.5,armpits
8,4,44," arm-pits, ",203,71442,71645,700.5,163,armpits
8,4,33, whatever ,97,71645,71742,719,151,armpits
8,4,45, aroma ,202,71742,71944,732.5,167.5,armpits
8,4,33, whatever ,104,71944,72048,762,143,armpits
8,4,46, finer ,95,72048,72143,774,173,armpits
8,4,34, I ,105,72143,72248,780,144,armpits
8,4,35, touch ,94,72248,72342,805,141,armpits
8,4,47, than ,105,72342,72447,814,175,armpits
8,4,35, touch ,95,72447,72542,820,155,armpits
8,4,36, or ,103,72542,72645,849,153,armpits
8,4,48, prayer; ,98,72645,72743,853,171,armpits
8,4,37, am ,200,72743,72943,868,158.5,armpits
8,4,48, prayer; ,102,72943,73045,888,181,armpits
8,4,38, touch'd ,198,73045,73243,904,143.5,armpits
8,4,49, This ,201,73243,73444,925.5,172,armpits
8,4,38, touch'd ,100,73444,73544,888,137,armpits
8,4,37, am ,100,73544,73644,862,157,armpits
8,4,48, prayer; ,101,73644,73745,861,173,armpits
8,4,22, miracle. ,99,73745,73844,820,126,armpits
8,4,35, touch ,101,73844,73945,798,158,armpits
8,4,46, finer ,101,73945,74046,792,171,armpits
8,4,33, whatever ,107,74046,74153,763,143,armpits
8,4,45, aroma ,192,74153,74345,746,162.5,armpits
8,4,33, whatever ,102,74345,74447,711,146,armpits
8,4,44," arm-pits, ",103,74447,74550,704,179,armpits
8,4,32, holy ,96,74550,74646,685,150,armpits
8,4,31, make ,98,74646,74744,633,149,armpits
8,4,43, these ,699,74744,75443,624,170.29,armpits
8,4,44," arm-pits, ",202,75443,75645,699,180.5,armpits
8,4,45, aroma ,299,75645,75944,750,178.67,armpits
8,4,46, finer ,103,75944,76047,791,179,armpits
8,4,47, than ,197,76047,76244,822,179,armpits
8,4,48, prayer; ,802,76244,77046,897.25,175.25,armpits
8,4,45, aroma ,100,77046,77146,732,168,armpits
8,4,42, of ,97,77146,77243,586,175,armpits
8,4,41, scent ,201,77243,77444,541,185,armpits
8,4,39, from; ,600,77444,78044,478.67,170,armpits
8,4,40, The ,100,78044,78144,531,166,armpits
8,4,44," arm-pits, ",99,78144,78243,677,166,armpits
8,4,45, aroma ,101,78243,78344,735,166,armpits
8,4,46, finer ,102,78344,78446,784,165,armpits
8,4,47, than ,101,78446,78547,833,171,armpits
8,4,48, prayer; ,200,78547,78747,881.5,177,armpits
8,4,49, This ,3296,78747,82043,948.94,176.97,armpits
8,4,48, prayer; ,901,82043,82944,903.44,175,armpits
8,4,49, This ,3199,82944,86143,925.28,189.44,armpits
8,4,50, head ,604,86143,86747,477.67,198.17,armpits
8,4,51, more ,97,86747,86844,557,187,armpits
8,4,41, scent ,99,86844,86943,554,172,armpits
8,4,13, and ,205,86943,87148,543,116,armpits
8,4,12," miracles, ",96,87148,87244,524,113,armpits
8,4,0, I ,302,87244,87546,464.33,86.33,armpits
8,4,1, believe ,107,87546,87653,520,97,armpits
8,4,3, the ,101,87653,87754,549,103,armpits
8,4,4, flesh ,91,87754,87845,581,97,armpits
8,4,5, and ,101,87845,87946,643,86,armpits
8,4,6, the ,101,87946,88047,677,91,armpits
8,4,7, appetites; ,207,88047,88254,714,92.5,armpits
8,4,8," Seeing, ",190,88254,88444,775.5,88.5,armpits
8,4,9," hearing, ",605,88444,89049,850.33,85.83,armpits
8,4,10," feeling, ",98,89049,89147,902,93,armpits
8,4,11, are ,500,89147,89647,960,95.2,armpits
8,4,10," feeling, ",96,89647,89743,860,109,armpits
8,4,19, me ,100,89743,89843,724,111,armpits
8,4,16, and ,307,89843,90150,653.67,115.67,armpits
8,4,14, each ,95,90150,90245,591,120,armpits
8,4,12," miracles, ",500,90245,90745,486.2,121.8,armpits
8,4,14, each ,98,90745,90843,593,119,armpits
8,4,16, and ,108,90843,90951,664,119,armpits
8,4,19, me ,93,90951,91044,728,120,armpits
8,4,21, a ,101,91044,91145,779,127,armpits
8,4,22, miracle. ,100,91145,91245,834,127,armpits
8,4,23, Divine ,100,91245,91345,879,125,armpits
8,4,24, am ,411,91345,91756,913.75,131.25,armpits
8,4,36, or ,90,91756,91846,842,150,armpits
8,4,33, whatever ,104,91846,91950,748,154,armpits
8,4,32, holy ,209,91950,92159,604.5,159,armpits
8,4,26, inside ,491,92159,92650,481.2,153.6,armpits
8,4,29, and ,102,92650,92752,579,148,armpits
8,4,32, holy ,95,92752,92847,668,148,armpits
8,4,33, whatever ,98,92847,92945,736,143,armpits
8,4,35, touch ,104,92945,93049,797,144,armpits
8,4,37, am ,95,93049,93144,853,144,armpits
8,4,38, touch'd ,606,93144,93750,901,145.17,armpits
8,4,46, finer ,100,93750,93850,788,165,armpits
8,4,44," arm-pits, ",98,93850,93948,712,165,armpits
8,4,43, these ,301,93948,94249,567,162.67,armpits
8,4,39, from; ,502,94249,94751,473.6,172.2,armpits
8,4,43, these ,298,94751,95049,703.67,186.67,armpits
8,4,48, prayer; ,200,95049,95249,875,183,armpits
8,4,49, This ,301,95249,95550,911.67,183,armpits
8,4,53," churches, ",402,95550,95952,588.25,212.75,armpits
8,4,44," arm-pits, ",311,95952,96263,690.67,176,armpits
8,4,22, miracle. ,82,96263,96345,815,129,armpits
8,4,10," feeling, ",308,96345,96653,927.67,99.33,armpits
8,4,9," hearing, ",92,96653,96745,854,96,armpits
8,4,1, believe ,102,96745,96847,485,108,armpits
8,4,12," miracles, ",198,96847,97045,464,113,armpits
8,4,1, believe ,399,97045,97444,494.25,101,armpits
8,4,0, I ,1101,97444,98545,463,86.36,armpits
8,4,1, believe ,102,98545,98647,506,92,armpits
8,4,4, flesh ,104,98647,98751,585,90,armpits
8,4,5, and ,118,98751,98869,629,83,armpits
8,4,6, the ,76,98869,98945,652,84,armpits
8,4,7, appetites; ,603,98945,99548,733,88,armpits
8,4,9," hearing, ",95,99548,99643,848,87,armpits
8,4,10," feeling, ",302,99643,99945,909,85,armpits
8,4,11, are ,499,99945,100444,965,87.2,armpits
8,4,10," feeling, ",200,100444,100644,867,104.5,armpits
8,4,19, me ,101,100644,100745,738,119,armpits
8,4,17, tag ,99,100745,100844,681,124,armpits
8,4,16, and ,103,100844,100947,622,131,armpits
8,4,13, and ,97,100947,101044,545,126,armpits
8,4,12," miracles, ",901,101044,101945,489,120.44,armpits
8,4,15, part ,100,101945,102045,620,128,armpits
8,4,16, and ,100,102045,102145,654,117,armpits
8,4,17, tag ,98,102145,102243,681,114,armpits
8,4,18, of ,102,102243,102345,711,114,armpits
8,4,19, me ,98,102345,102443,739,117,armpits
8,4,20, is ,102,102443,102545,762,118,armpits
8,4,22, miracle. ,200,102545,102745,812,120.5,armpits
8,4,23, Divine ,199,102745,102944,880,121,armpits
8,4,24, am ,100,102944,103044,926,116,armpits
8,4,25, I ,199,103044,103243,937.5,121.5,armpits
8,4,23, Divine ,101,103243,103344,879,131,armpits
8,4,35, touch ,101,103344,103445,787,146,armpits
8,4,44," arm-pits, ",109,103445,103554,706,165,armpits
8,4,43, these ,90,103554,103644,645,167,armpits
8,4,29, and ,100,103644,103744,600,153,armpits
8,4,28," out, ",100,103744,103844,576,152,armpits
8,4,27, and ,100,103844,103944,544,155,armpits
8,4,26, inside ,3400,103944,107344,475.24,147.18,armpits
8,4,41, scent ,201,107344,107545,567.5,164,armpits
8,4,30, I ,100,107545,107645,614,155,armpits
8,4,31, make ,199,107645,107844,652,150,armpits
8,4,32, holy ,400,107844,108244,685.25,149,armpits
8,4,33, whatever ,100,108244,108344,755,153,armpits
8,4,34, I ,300,108344,108644,833.67,161.67,armpits
8,4,38, touch'd ,802,108644,109446,922.12,146.5,armpits
8,4,35, touch ,105,109446,109551,827,149,armpits
8,4,33, whatever ,96,109551,109647,751,154,armpits
8,4,44," arm-pits, ",104,109647,109751,668,172,armpits
8,4,42, of ,96,109751,109847,592,180,armpits
8,4,40, The ,98,109847,109945,519,183,armpits
8,4,39, from; ,499,109945,110444,473.8,176,armpits
8,4,40, The ,101,110444,110545,527,168,armpits
8,4,41, scent ,199,110545,110744,568.5,171,armpits
8,4,42, of ,100,110744,110844,599,171,armpits
8,4,43, these ,100,110844,110944,634,173,armpits
8,4,44," arm-pits, ",300,110944,111244,689,178,armpits
8,4,45, aroma ,300,111244,111544,749,180,armpits
8,4,46, finer ,401,111544,111945,800.5,184,armpits
8,4,48, prayer; ,205,111945,112150,892.5,174,armpits
8,4,49, This ,413,112150,112563,932.25,174.75,armpits
8,4,55, and ,93,112563,112656,742,198,armpits
8,4,53," churches, ",189,112656,112845,627,202,armpits
8,4,51, more ,106,112845,112951,546,204,armpits
8,4,50, head ,494,112951,113445,483,194.8,armpits
8,4,51, more ,100,113445,113545,526,198,armpits
8,4,52, than ,99,113545,113644,581,195,armpits
8,4,53," churches, ",201,113644,113845,635,193,armpits
8,4,54," bibles, ",199,113845,114044,691.5,196.5,armpits
8,4,55, and ,514,114044,114558,749.4,213.8,armpits
8,4,58, creeds. ,4391,114558,118949,845.55,201.23,armpits
8,4,56, all ,95,118949,119044,759,204,armpits
8,4,55, and ,403,119044,119447,732.25,205.75,armpits
8,4,56, all ,199,119447,119646,756,202,armpits
8,4,57, the ,198,119646,119844,785.5,203,armpits
8,4,58, creeds. ,400,119844,120244,818.25,203.5,armpits
8,4,56, all ,100,120244,120344,768,197,armpits
8,4,54," bibles, ",301,120344,120645,700,192.33,armpits
8,4,55, and ,200,120645,120845,760,215,armpits
8,4,57, the ,299,120845,121144,797.67,194.33,armpits
8,4,56, all ,102,121144,121246,756,209,armpits
8,4,55, and ,399,121246,121645,736.75,209.5,armpits
8,4,54," bibles, ",200,121645,121845,717,199,armpits
8,4,55, and ,399,121845,122244,743.5,209,armpits
8,4,56, all ,101,122244,122345,763,208,armpits
8,4,57, the ,200,122345,122545,780.5,208,armpits
8,4,58, creeds. ,299,122545,122844,813.33,208,armpits
8,4,56, all ,100,122844,122944,768,210,armpits
8,4,53," churches, ",301,122944,123245,615.67,212.67,armpits
8,4,40, The ,101,123245,123346,507,159,armpits
8,4,12," miracles, ",499,123346,123845,485.4,118.8,armpits
8,4,1, believe ,600,123845,124445,502,87.83,armpits
8,4,2, in ,200,124445,124645,539.5,91.5,armpits
8,4,3, the ,400,124645,125045,560.75,94,armpits
8,4,4, flesh ,100,125045,125145,592,94,armpits
8,4,5, and ,500,125145,125645,634,88.2,armpits
8,4,6, the ,201,125645,125846,665.5,86.5,armpits
8,4,7, appetites; ,898,125846,126744,720.56,89,armpits
8,4,8," Seeing, ",400,126744,127144,785,91.5,armpits
8,4,9," hearing, ",901,127144,128045,849.33,95.22,armpits
8,4,8," Seeing, ",300,128045,128345,803,85,armpits
8,4,15, part ,100,128345,128445,615,110,armpits
8,4,12," miracles, ",1299,128445,129744,494.54,113.46,armpits
8,4,13, and ,702,129744,130446,560.43,119,armpits
8,4,14, each ,499,130446,130945,584.2,124,armpits
8,4,15, part ,500,130945,131445,627,116.6,armpits
8,4,16, and ,600,131445,132045,648.67,118.5,armpits
8,4,17, tag ,499,132045,132544,689.6,123.2,armpits
8,4,18, of ,101,132544,132645,718,122,armpits
8,4,19, me ,102,132645,132747,733,123,armpits
8,4,20, is ,498,132747,133245,759.6,126,armpits
8,4,22, miracle. ,4600,133245,137845,840.57,121.98,armpits
8,4,23, Divine ,3101,137845,140946,858.39,122.06,armpits
8,4,17, tag ,100,140946,141046,696,118,armpits
8,4,12," miracles, ",399,141046,141445,505.75,128,armpits
8,4,26, inside ,700,141445,142145,477.71,146.14,armpits
8,4,27, and ,1000,142145,143145,517.8,145.8,armpits
8,4,28," out, ",101,143145,143246,560,149,armpits
8,4,29, and ,299,143246,143545,581,147,armpits
8,4,31, make ,400,143545,143945,650.25,147.75,armpits
8,4,33, whatever ,700,143945,144645,746.57,148,armpits
8,4,34, I ,100,144645,144745,781,149,armpits
8,4,35, touch ,1200,144745,145945,805.75,151.5,armpits
8,4,36, or ,301,145945,146246,837.67,155.67,armpits
8,4,37, am ,2699,146246,148945,868.89,152.22,armpits
8,4,38, touch'd ,1900,148945,150845,894.74,149.37,armpits
8,4,49, This ,900,150845,151745,919.78,174.67,armpits
8,4,48, prayer; ,10402,151745,162147,868.19,174.24,armpits
8,4,37, am ,499,162147,162646,856.4,151,armpits
8,4,36, or ,100,162646,162746,844,139,armpits
8,4,22, miracle. ,400,162746,163146,807,126,armpits
8,4,18, of ,100,163146,163246,709,126,armpits
8,4,17, tag ,4003,163246,167249,685.73,123,armpits
8,4,18, of ,297,167249,167546,713.67,124.67,armpits
8,4,19, me ,302,167546,167848,735.67,125,armpits
8,4,20, is ,299,167848,168147,762.67,122.67,armpits
8,4,21, a ,499,168147,168646,775.4,121,armpits
8,4,22, miracle. ,1401,168646,170047,817.36,119.36,armpits
8,4,23, Divine ,699,170047,170746,861.86,114.57,armpits
8,4,22, miracle. ,407,170746,171153,702,106.75,armpits
8,4,13, and ,94,171153,171247,540,127,armpits
8,4,12," miracles, ",200,171247,171447,493,133,armpits
8,4,26, inside ,8006,171447,179453,480.94,150.78,armpits
8,4,39, from; ,995,179453,180448,480.8,167.1,armpits
8,4,26, inside ,1499,180448,181947,490.2,150,armpits
8,4,27, and ,1000,181947,182947,532.6,147.2,armpits
8,4,28," out, ",700,182947,183647,563.71,150.71,armpits
8,4,29, and ,200,183647,183847,600,148,armpits
8,4,30, I ,400,183847,184247,613.25,149.5,armpits
8,4,31, make ,1503,184247,185750,637.13,150.13,armpits
8,4,32, holy ,18399,185750,204149,680.53,150.37,armpits
8,4,44," arm-pits, ",997,204149,205146,678.7,173.1,armpits
8,4,43, these ,211,205146,205357,639.5,177,armpits
8,4,44," arm-pits, ",308,205357,205665,685.67,178,armpits
8,4,45, aroma ,483,205665,206148,748.6,183.6,armpits
8,4,46, finer ,401,206148,206549,787.25,172.75,armpits
8,4,47, than ,398,206549,206947,830,173.5,armpits
8,4,45, aroma ,300,206947,207247,639.33,161,armpits
8,4,42, of ,100,207247,207347,587,177,armpits
8,4,41, scent ,400,207347,207747,552.25,182.5,armpits
8,4,40, The ,201,207747,207948,535,182,armpits
8,4,41, scent ,599,207948,208547,556.17,177.67,armpits
8,4,42, of ,302,208547,208849,599.33,185,armpits
8,4,43, these ,198,208849,209047,610.5,183.5,armpits
8,4,41, scent ,501,209047,209548,565.4,174,armpits
8,4,42, of ,100,209548,209648,602,175,armpits
8,4,43, these ,399,209648,210047,613.25,174,armpits
8,4,44," arm-pits, ",605,210047,210652,665.33,170.83,armpits
8,4,45, aroma ,996,210652,211648,744.2,178.2,armpits
8,4,46, finer ,204,211648,211852,800.5,177.5,armpits
8,4,47, than ,695,211852,212547,813,179,armpits
8,4,58, creeds. ,1404,212547,213951,807,206,armpits
8,4,27, and ,96,213951,214047,532,155,armpits
8,4,12," miracles, ",202,214047,214249,502.5,123.5,armpits
8,4,1, believe ,798,214249,215047,499.38,91.75,armpits
8,4,2, in ,304,215047,215351,541,98,armpits
8,4,4, flesh ,96,215351,215447,588,101,armpits
8,4,5, and ,200,215447,215647,642.5,101,armpits
8,4,6, the ,100,215647,215747,661,99,armpits
8,4,7, appetites; ,404,215747,216151,691.75,99,armpits
8,4,8," Seeing, ",598,216151,216749,782.17,98.67,armpits
8,4,9," hearing, ",298,216749,217047,912,105,armpits
8,4,10," feeling, ",100,217047,217147,936,101,armpits
8,4,11, are ,100,217147,217247,945,96,armpits
8,4,10," feeling, ",103,217247,217350,910,96,armpits
8,4,5, and ,98,217350,217448,621,86,armpits
8,4,1, believe ,299,217448,217747,473,102,armpits
8,4,12," miracles, ",503,217747,218250,503.2,116.4,armpits
8,4,13, and ,99,218250,218349,559,119,armpits
8,4,14, each ,499,218349,218848,593.4,122.6,armpits
8,4,16, and ,200,218848,219048,664,119,armpits
8,4,17, tag ,301,219048,219349,684.67,119,armpits
8,4,18, of ,99,219349,219448,736,130,armpits
8,4,34, I ,100,219448,219548,778,137,armpits
8,4,35, touch ,100,219548,219648,795,135,armpits
8,4,22, miracle. ,199,219648,219847,834,125,armpits
8,4,23, Divine ,503,219847,220350,763.2,130.2,armpits
8,4,27, and ,101,220350,220451,528,144,armpits
8,4,26, inside ,405,220451,220856,493.5,149,armpits
8,4,28," out, ",192,220856,221048,556.5,151.5,armpits
8,4,29, and ,107,221048,221155,586,152,armpits
8,4,31, make ,195,221155,221350,639.5,152,armpits
8,4,32, holy ,398,221350,221748,691.5,152,armpits
8,4,33, whatever ,306,221748,222054,776.67,160.33,armpits
8,4,35, touch ,97,222054,222151,826,157,armpits
8,4,36, or ,99,222151,222250,845,154,armpits
8,4,37, am ,212,222250,222462,869.5,150.5,armpits
8,4,38, touch'd ,194,222462,222656,892.5,150,armpits
8,4,37, am ,95,222656,222751,879,151,armpits
8,4,33, whatever ,98,222751,222849,712,148,armpits
8,4,29, and ,101,222849,222950,587,143,armpits
8,4,27, and ,107,222950,223057,522,150,armpits
8,4,39, from; ,392,223057,223449,479.25,172,armpits
8,4,40, The ,102,223449,223551,536,172,armpits
8,4,41, scent ,96,223551,223647,574,172,armpits
8,4,42, of ,104,223647,223751,603,173,armpits
8,4,43, these ,303,223751,224054,639.33,177,armpits
8,4,44," arm-pits, ",97,224054,224151,658,177,armpits
8,4,45, aroma ,96,224151,224247,753,175,armpits
8,4,46, finer ,205,224247,224452,787.5,173,armpits
8,4,47, than ,199,224452,224651,832,169,armpits
8,4,48, prayer; ,303,224651,224954,894.67,168.33,armpits
8,4,45, aroma ,198,224954,225152,658.5,165.5,armpits
8,4,40, The ,95,225152,225247,530,177,armpits
8,4,51, more ,105,225247,225352,507,197,armpits
8,4,50, head ,299,225352,225651,486,208.67,armpits
8,4,51, more ,98,225651,225749,534,195,armpits
8,4,52, than ,201,225749,225950,567,196.5,armpits
8,4,53," churches, ",405,225950,226355,613,203.75,armpits
8,4,54," bibles, ",399,226355,226754,701.75,212.5,armpits
8,4,56, all ,100,226754,226854,762,209,armpits
8,4,57, the ,5788,226854,232642,802.33,210.67,armpits
